..................#########..........
..................#.......#..........
#########.........#.......#..........
#.................#.......#..........
#.......#####.....#.......#..........
#.......#...#.....#.......#..........
#.......#.#############...#..........
#.......#.#.#.....#...#...#..........
#...#########.....#############......
#...#...#.#...........#...#...#......
#.###########.........#####...#......
#.#.#...#.#.#.................#......
#####...#.#.#.................#......
..#.....#.#.#.................#......
..#.....#####.................#......
..#.......#...................#......
..#.......#.................#########
..#.......#.................#.#.....#
..#########.................#.#.....#
............................#.#.....#
......###########.........#####.....#
......#.........#.........#.#.......#
......#.......#####.......#.#.......#
......#.......#.#.#.......#.#.......#
......#####...#.#.#.......###########
..........#...#.#.#.........#........
......^########.#.#.........#........
..........#.....#.#.........#........
..........#.....#############........
..........#.......#..................
..........#.......#..................
..........#.......#..................
..........#########..................